Parallel programming:
- Parallel Programming with MPI - Peter Pacheco
- Using OpenMP: Portable Shared Memory Parallel Programming (Scientific and Engineering Computation)
- Structured Parallel Programming: Patterns for Efficient Computation

Best coding practices:
- Writing Secure Code - Howard, Michael and David LeBlanc
- Test-Driven Development: By example - Kent Beck
- Refactoring: Improving the Design of Existing Code
- Programming Pearls
- Performance Solutions: A Practical Guide to Creating Responsive, Scalable Software - Smith, Connie U. and Lloyd G. Williams
- Generative Programming: Methods, Tools, and Applications - Krzysztof Czarnecki, Ulrich Eiseneckers
- The Scrum Field Guide: Practical Advice for Your First Year -     Mitch Lacey  
- Agile Estimating and Planning - Mike Cohn
- User Stories Applied: For Agile Software Development - by Mike Cohn
- Continuous Delivery - Jez Humble and Dave Farley

Software security:
- Exploiting Software: How to Break Code - Greg Hoglund, Gary McGraw 
- Exploiting Online Games: Cheating Massively Distributed Systems - Greg Hoglund, Gary McGraw
- Rootkits: Subverting the Windows Kernel - Greg Hoglund, Jamie Butler

C#:
- Concurrency in C# Cookbook - Stephen Cleary
- Introduction to Rx - Lee Campbell

Javascript books:
- JavaScript: The Good Parts - Douglas Crockford
- A Software Engineer Learns HTML5, JavaScript and jQuery - Dane Cameron
- The Principles of Object-Oriented JavaScript - Nicholas C. Zakas
- Secrets of the JavaScript Ninja - John Resig

Python books:
- Python High Performance Programming - Gabriele Lanaro
- Expert Python Programming - Tarek Ziadé
- Mining the Social Web: Data Mining Facebook, Twitter, LinkedIn, Google+, GitHub, and More - Matthew A. Russell - apparently a great practical book on production Python code and web coding + a bit of data processing
- Python Web Programming - Steve Holden 
- Foundations of Python Network Programming -  Brandon Rhodes
- Programming Python -  Mark Lutz
- Flask Web Development: Developing Web Applications with Python - Miguel Grinberg
- Learning IPython for Interactive Computing and Data Visualization Paperback – Cyrille Rossan
- The Python Standard Library by Example (Developer's Library) - Doug Hellmann 
- Test-Driven Development with Python - Harry J. W. Percival

Continuous Integration:
- Jenkins: The Definitive Guide - John Ferguson Smart 
- Continuous Delivery: Reliable Software Releases through Build, Test, and Deployment Automation - Jez Humble, David Farley
- The Phoenix Project: A Novel about IT, DevOps, and Helping Your Business Win - Gene Kim
- The Visible Ops Handbook: Implementing ITIL in 4 Practical and Auditable Steps - Gene Kim
- The Goal: A Process of Ongoing Improvement - Eliyahu M. Goldratt

Data mining books:
- Data Science for Business: What you need to know about data mining and data-analytic thinking - Foster Provost - has GREAT reviews!!!
- Think Bayes - Allen B. Downey 
- Data Mining: Concepts and Techniques, Third Edition - Jiawei Han
- Data Smart: Using Data Science to Transform Information into Insight - John W. Foreman 
- Mastering Machine Learning With scikit-learn - Gavin Hackeling 

Machine learning:
- Python Machine Learning - Sebastian Raschka
- Data Mining: Practical Machine Learning Tools and Techniques - Ian H. Witten
- Machine Learning: The Art and Science of Algorithms that Make Sense of Data - Peter Flach
- Machine Learning - Tom M. Mitchell 
- Predictive Analytics For Dummies - Anasse Bari 
- Learning Data Mining with Python - Robert Layton
- Pattern Recognition and Machine Learning - Christopher Bishop
- Introduction to the Math of Neural Networks - Jeff Heaton 
- Deep Belief Nets in C++ and CUDA C: Volume 1: Restricted Boltzmann Machines and Supervised Feedforward Networks - Timothy Masters 
- Practical Neural Network Recipies in C++ - Timothy Masters 
- Deep Belief Nets in C++ and CUDA C: Volume II: Autoencoding in the Complex Domain (Volume 2) - Timothy Masters 
- Pattern Classification - Richard O. Duda
- Programming Collective Intelligence: Building Smart Web 2.0 Applications - Toby Segaran
- Neural Networks: Tricks of the Trade - Grégoire Montavon
- Probability Theory: The Logic of Science
- Machine Learning: a Probabilistic Perspective - Murphy

Unity textbooks:
- Unity 4.x Cookbook - Matt Smith
- Unity 3.x Game Development Essentials (Community Experience Distilled) - Will Goldstone 
- Unity Game Development in 24 Hours, Sams Teach Yourself (Sams Teach Yourself -- Hours) - Mike Geig
- Unity 4.x Game AI Programming - Aung Sithu Kyaw
- Mastering Unity 2D Game Development - Simon Jackson

Computer vision:
- Computer Vision a modern approach - 2nd edition
- Computer and Machine Vision, Fourth Edition: Theory, Algorithms, Practicalities - E. R. Davies 
- OpenCV for Secret Agents - Joseph Howse
- Mastering OpenCV with Practical Computer Vision Projects - Daniel Lélis Baggio - contains a lot of stuff on face detection!
- Multiple View Geometry in Computer Vision - Richard Hartley

Autonomous vehicles:
- Autonomous Intelligent Vehicles: Theory, Algorithms, and Implementation (Advances in Computer Vision and Pattern Recognition) - Hong Cheng
- The DARPA Urban Challenge: Autonomous Vehicles in City Traffic (Springer Tracts in Advanced Robotics) 2010 edition - Martin Buehler
- The DARPA Urban Challenge: Autonomous Vehicles in City Traffic (Springer Tracts in Advanced Robotics) 2012 edition - Christopher Rouff 

OCR textbooks:
- Guide to OCR for Arabic Scripts - Volker Märgner
- OCR with a Smile!: An Operator's Guide to Optical Character Recognition - Fred F. Ross
- Optical Character Recognition Technology -- Application of ABBYY FineReader 11 - Daniel Huang
- Video Text Detection (Advances in Computer Vision and Pattern Recognition) - Tong Lu
- Chinese Handwriting Recognition: An Algorithmic Perspective - Tonghua Su
- Arabic and Chinese Handwriting Recognition: - David Doermann

Virtualization:
- The Docker Book: Containerization is the new virtualization - James Turnbull
- Learning Saltstack - Colton Myers

Software architecture:
- Patterns of Enterprise Application Architecture – Martin Fowler
- Architecture: Working With Stakeholders Using Viewpoints and Perspectives Hardcover – Nick Rozanski 
- Software Product Lines: Practices and Patterns - Paul Clements

Ruby:
- The Well-Grounded Rubyist Paperback – David A. Black
- The Rails 4 Way - Obie Fernandez, Kevin Faustino 
- Learn Ruby On Rails For Web Development: Learn Rails The Fast And Easy Way! – John Elder
- Ruby on Rails Tutorial: Learn Web Development with Rails – Michael Hartl 

Android:
- Android Design Patterns: Interaction Design Solutions for Developers - Greg Nudelman 
- Advanced Android Application Development -  Joseph Annuzzi Jr
- Android Hacker's Handbook - Joshua J. Drake
- Professional Android 4 Application Development - Reto Meier
- Smashing Android UI: Responsive User Interfaces and Design Patterns for Android Phones and Tablets - Juhani Lehtimaki

Regular expressions:
- Mastering Python Regular Expressions - Félix López
- Regular Expressions Cookbook - Jan Goyvaerts

Management books:
- Peopleware: Productive Projects and Teams - Tom DeMarco
- Small Is Beautiful: Economics as if People Mattered Paperback – E. F. Schumacher
- Joel on Software: And on Diverse and Occasionally Related Matters That Will Prove of Interest to Software Developers, Designers, and Managers, and to Those Who, Whether by Good Fortune or Ill Luck, Work with Them in Some Capacity - Joel Spolsky
- Principles of Software Engineering Management - Gilb, Tom
- The Lean Startup: How Today's Entrepreneurs Use Continuous Innovation to Create Radically Successful Businesses - Eric Ries 

Product development and design:
- Don't Make Me Think, Revisited: A Common Sense Approach to Web Usability - Steve Krug
- User Interface Design for Programmers - Avram Joel Spolsky
- UI is Communication: How to Design Intuitive, User Centered Interfaces by Focusing on Effective Communication - Everett N McKay
- Designing Interfaces: Patterns for Effective Interaction Design - Jenifer Tidwell
- Universal Principles of Design, Revised and Updated: 125 Ways to Enhance Usability, Influence Perception, Increase Appeal, Make Better Design Decisions, and Teach through Design - William Lidwell
- 100 Things Every Designer Needs to Know About People (Voices That Matter) - Susan Weinschenk
- Designing Multi-Device Experiences: An Ecosystem Approach to User Experiences across Devices - Michal Levin 
- Microinteractions: Full Color Edition: Designing with Details - Dan Saffer 
- Hooked: How to Build Habit-Forming Products - Nir Eyal 

Cloud computing:
- AWS Scripted - Christian Cerri 

Web development:
- Teach Yourself VISUALLY WordPress - George Plumley
